TTTTTTTTTTTTTT-T
T-------------PT
TBTTTTTTTTTTTT-T
T---ET-T-----T-T
T----TTTTTTTTT-T
TTTT---TE---GT-T
TE-----B--TTTT-T
TK-TTTTT--T-E--T
TTTT--ET--T-TT-T
TKETTTTTTTT----T
T-----------TE-T
TTTTTTTTTTTTTT-T
