TTTTTTTTTTTTTTTT
TP--T---E-T----T
----TTT---------
T-T---T----TTTTT
T--E---T---E---T
TT--TT--TTTT---T
-BT--E---TE-----
T-KT---T--T----T
TTTTTT--E--T---T
---E--T--T--TT--
T-E--BGT--E--KTT
TTTTTTTTTTTTTTTT
