TTTTTTTTTT-TTTTTTT-TTTTTTTTTTTTT
TP-----T-----E-T----T----E-----T
T--T---T-------T--T---T--------T
---TT-TTTTT-TTTTTTTTTTTTTTTTT---
T--T-----T--E----TTT-T--E-T----T
T--T---E-T---------T----T---T--T
TE-T-TTTTTTTTTTTTT-TTTTTTTTTT--T
T--T-T---E-T--E--T------E-T---ET
T--T-T-----T-----T------TTT-T--T
T--T-T-TT-TTT-TTTTT--TTTT-T-T--T
TTTT-T-T-------T--------T-TTTTTT
---T-T-T-------T--------T-T-T---
T----T-T-TTTTTTTTTTTTTT-T-T-T--T
TTTT-T-T-TG----E-----GT---T-T--T
TK-T-T-T-TG--------E-GTTT-T-T--T
T--T-T-T-TTTTTTTBTTTTTT-T-T----T
T--T-T-T-------T---T--T---T-TTTT
T--T-T-T-------T-T-----TT-T-T--T
T--T-T-TTTTTT-TTTTTTTT-TT-T-TK-T
T--T-T---T-T---------T--E-T-T--T
T--T-T-T---T---E-----T----T-T--T
T--T-T-TTTTTTTT--TTTTTTTTTT-T--T
T-ET---E-T-E-------T----E---T--T
T--T-----T---------T--------T--T
T--TTTTTTTTBTTTTTTTTTTTTTTTTT--T
T------E------T----------------T
T-------------T---------E------T
TTTTTTTTTT-TTTTTTT-TTTTTTTTTTTTT
