TTTTTTT-TTTTTT-T
TP--------TE---T
TTTTTTT---TTTT-T
--E--E----------
TTTTTT-TTTTTTTTT
T----ET----T---T
TG-------T-----T
TTTTTTTTTTT-T--T
----T--T-ETET---
TE-T------TTTTTT
T------T-------T
TTTTTTT-TTTTTT-T
