TTTTTTTTTTTTTTTT
P------T--T-----
TTTTTT-TE-T-TT-T
T-E----T-----TKT
TTTTTTBTTBTTTTTT
-------T------K-
TT----ETTTTTTTTT
---TTTTT--------
TTTTTTTTTBTTTTTT
TE----GT---T-E-T
----E--T--------
TTTTTTTTTTTTTTTT
